1111111111111111111111111111111111
100000000000000000000C000000000001
1000000100000000000000000000000001
10000C1000000000000000000000000001
10000100000000100C1000000000010001
1000000000000011111000000000000001
1000000000000000000100000000000001
100000000000C000000000000E000000C1
1000000000000000000000000000000001
1000000001C00000000000000000000001
1010000000100001111000000000000001
1000C000000000000C1000000000000001
1000000000000001101100000000000001
1000000000000000101110000000000011
100000000000000000000CP000000C0001
1111111111111111111111111111111111